1111111111111111111111111111111111
1E0000300000000C00000C000300000001
1010010100120000101001000000010101
1010010010101012001001000000010101
1P0000000C00C0000000000000000000C1
1111111111111111111111111111111111