1111111111111111111111111111111111
1E0000300000000C00000C000300000001
1010010100120000101001000000010101
1010010010101012001001000000010101
100000000C00C0000000000000000000C1
10010C00100000P0000001000000010001
1001000000000000110000C00000000001
1000000C000010000000000011100C0001
1111111111111111111111111111111111